NO ./textures/wolfenstein/grey_stone.xpm
EA ./textures/wolfenstein/purple_stone.xpm
WE ./textures/wolfenstein/red_brick.xpm
SO ./textures/wolfenstein/wood.xpm

F 220, 100, 0
C 149 , 200, 110









        1111111111111111111111111
        1000000000110000000000001
        1011000001110000000000001
        1001000000000000000000001
111111111011000001110000000000001
100000000011000001110111111111111
11110111111111011100000010001
11110111111111011101010010001
11000000110101011100000010001
11111111111000000000000001101                                           
11000000000000001101010010001
11000001110101011111011110N01
11110111 1110101 101111010001
11111111 1111111 111111111111
