NO ./textures/doom/Doom1.xpm42
EA ./textures/doom/Doom2.xpm42
WE ./textures/doom/Doom3.xpm42
SO ./textures/doom/Doom4.xpm42

F 200, 1, 1 
C 200, 1, 1 






        1111111111111111111111111
        1000000E00110000000000001
        1011000001110000000000001
        1001000000000000000000001
111111111011000001110000000000001
100000000011000001110111111111111
11110111111111011100000010001
11110111111111011101010010001
11000000110101011100000010001
11111111111000000000000001101                                      
11000000000000001101010010001
11000001110101011111011110001
11110111 1110101 101111010001
11111111 1111111 111111111111
